....................
.S#####.............
.....#..............
...TT#..............
.....#..............
.....#####..........
.........#..........
.........#....TT....
...#######..........
...#................
...##############E..
....................
....................
....................
